111111111111111111111111111111111111111111111111111111
1E0000000000000C00000C00000000000000000000000000000C11
101001010010000010100100000001010000000000111111111101
1010010010101010001001000E0001010000000CC0000000001111
1P0000000C00C0000000000000000000C0000000000000000000C1
101001001010101000100100000001010000000000000EE0000001
100000000C00C0000000000000000000C000000000000000000001
101001001010101000100100000001010000000000000000000001
101001001010101000100100000001010000000011100000000001
100E00000C00C00000000000E0000000C000000000000000000001
1E0000000000000C00000C00000000000000000000000000000001
101001010010000010100100000001010000000001000000000001
1010010010101010001001000E0001010000000000000000000001
100000000C00C0000000000000000000C00000000CC00000000001
101001001010101000100100000001010000000001111111111111
100000000C00C0000000000000000000C111110000000000000001
101001001010101000100100000001010111111100000000000001
101001001010101000100100000001010111111110000000000001
100E00000C00C00000000000E0000000C000000000000000000001
101001001010101000100100000001010000000000000000000001
100000000C00C0000000000000000000C000000000000000000001
101001001010101000100100000001010000000000000000000001
100E00000C00C00000000000E0000000C000000000000000000001
1E0000000000000C00000C00000000000000000000000000000001
101001010010000010100100000001010000000000000000000001
1010010010101010001001000E0001010000000000000000000001
100000000C00C0000000000000000000C000CC0000000000000001
101001001010101000100100000001010000000000000000011111
100000000C00C0000000000000000000C111110000000000000001
101001001010101000100100000001010111111100000000000001
101001001010101000100100000001010111110000000000000001
100E00000C00C00000000000E0000000C000000000000000000001
111111111111111111111111111111111111111111111111111111